2 0 0 1 1 1 1 1 1 1
0 0 0 1 1 111 1 1 1 50021
0 0 0 1 1 1 1 1 1 1
1 1 1 1 1 1 1 1 1 1
1 1 211 75021 1 1 1 1 1 1
1 1 1 1 1 311 100021 1 1 1
1 1 1 1 1 1 1 1 1 1000031
100031 1 1 1 1 1 1 1 1 1
1 1 1 1 1 1 1 411 1 1
1 1 1 1 1 1 1 1 1 2000031